7x8
GXGXXXXX
X.X....X
XX..X.XG
E..X...X
XXXX.XXG
G....X.G
XXXXXXXX