7x8
XXXXXXXX
X.X....X
XX..X.XX
E..X...X
XXXX.XXX
X....X.X
XXXXXXXX