7x8
XXGXXXXX
X.X....X
XX..X.XG
X..X...X
XXEX.XXG
G....X.G
XXXXXXXX