9x9
XXGXXXXXX
X.X.....X
XX..X.XXG
E..X....X
XXX..XXXG
X...XX..G
X.XX.X..X
X.......X
XXXXXXXXX