9x9
XXGXXXXXX
X.X.....X
XX..X.X.G
E..X....X
XXXX.XXXG
G....X..X
X....X..G
G....X..G
XXXXXXXXX